电视机 延保 的话 ， 是 谁 给 修 呢 ， 厂家 还是 你们 苏宁 包 的 检修 工	__label__延保
零钱宝 什么 时候 到 帐	__label__零钱宝
我 的 账号 临时 冻结   无法 还款	__label__易付宝账户解冻
零钱宝 中 显示 的 收益 是 当天 的 还是 前天 的	__label__零钱宝
任性付 线上 购物 如何 收费 ?	__label__任性付
任性付 有 哪些 优势 ？	__label__任性付
账号 如何 登陆	__label__易付宝账户
我存 的 钱 没有 看 有 收益 吗	__label__零钱宝
想 问下 任性贷 有 额度 怎么 消费	__label__任性贷
使用 任性付 的 方法 ？	__label__任性付
任性 借 如何 收费 ?	__label__任性付
把 名字 的 一个 字 写错 了	__label__转账
任性付 是否 可 与 其他 优惠 票券 搭配 使用 ？	__label__任性付
任性贷 可以 在 苏宁易购 线上 支付 吗	__label__任性贷
合并 上报 包含 全部 类型 的 贷款 么 ？	__label__任性付
什么 是 易付宝	__label__易付宝账户
修改 绑定 手机 需要 哪些 资料	__label__易付宝修改绑定手机号码
贷款 的 利息 是 多少	__label__任性贷
购买 的 理财 ， 零钱宝 显示 冻结 中 ， 能 撤销 了 重新 买 么	__label__理财
订单 如何 付款	__label__支付
变现 是 什么	__label__理财
易付宝 提现 什么 时候 到 账	__label__易付宝账户
易玺 是 什么	__label__易玺
申请 的 变现 成功 了 吗	__label__理财
可以 转账 到 哪家 银行卡	__label__转账
易付宝 余额 提现 程序	__label__易付宝账户
苏宁 卡 怎么 用 不了	__label__支付
我 可以 直接 点 更换 基金 吗	__label__零钱宝
为什么 变现 这么 慢 ， 之前 很快 就 到 账 了	__label__理财
我 的 支付 密码 忘 了 怎么办	__label__企业易付宝
绑定 的 银行卡 不用 了 ，   怎么办	__label__易付宝绑定解绑银行卡
现金 贷款 费率 怎么 算	__label__任性贷
易玺 激活 不了 是 什么 原因	__label__易玺
我要 注销 苏宁金融 的 账户	__label__易付宝注销
任性贷 门店 扫码 显示 此 交易 存在 风险 什么 意思	__label__任性贷
企业 汇款 退款 周期	__label__企业易付宝
苏宁 卡 发票 的 内容 可以 开 生活 日用品 么	__label__礼品卡
零钱宝 转出 至 银行卡 ， 未到 帐	__label__零钱宝
请问 怎么 取消 小额 免 密码	__label__易付宝支付密码
如何 用 支付宝 支付	__label__支付
怎么 解除 免密 支付	__label__易付宝支付密码
苏宁金融 的 零钱宝 可以 随用 随取 吗	__label__零钱宝
提 现有 没有 限制 ？ 就 跟 余额 宝 一样 是 吧	__label__零钱宝
能 更改 付款 方式 吗	__label__支付
为什么 阿里 蚂蚁 花呗 、 京东白条 就 不用 上报 征信 ？	__label__任性付
提现 迟迟 不到 账	__label__企业易付宝
定期 理财 变现 得话 ， 具体 收益 是不是 没有 了	__label__理财
怎么 用 微信 支付	__label__支付
随借 随 还 如何 还款 ？	__label__任性付
零钱宝 可以 一次 转入 大额 的 吗 ， 怎么 操作	__label__零钱宝
任性付 如何 解冻 ？	__label__任性付
可以 修改 支付 方式 吗	__label__支付
支持 微信 支付 吗	__label__支付
信用卡 分期 手续费 怎么 收取	__label__支付
易玺 如何 购买	__label__易玺
实名认证 可是 名字 打错 了 为什么 改不了 了	__label__易付宝实名认证
门店 付款	__label__支付
任性付 非 账单 贷款 业务 每月 几号 还款 ？	__label__任性付
企业 易付宝 充值 什么 时候 到 账	__label__企业易付宝
固收 理财	__label__理财
信用卡 还款 ， 信息 填错 了 能 撤销 吗	__label__信用卡还款
怎么 解挂 账户	__label__易付宝账户
任性付 如何 还款 ？	__label__任性付
初级 认证 流程	__label__易付宝实名认证
任性付 的 还款 规则 是 什么 ？	__label__任性付
现在 不能 组合 支付 了 么	__label__支付
我 有 额度 为什么 用 不了 ， 用 不了 为什么 给 我 额度	__label__任性贷
实名认证 通过率 高 的 银行 有 哪些 ？	__label__任性付
任性付 非 账单 贷款 业务 每月 几号 还款 ？	__label__任性付
高级 认证 怎么 操作	__label__易付宝实名认证
每天 的 收益 如何 算	__label__零钱宝
理财 期限 多久	__label__理财
苏宁 卡 一次 可以 用 几张	__label__礼品卡
怎么 申请 解冻	__label__易付宝账户解冻
盗抢 碎险 怎么 确定 的	__label__延保
支付 设置 密码	__label__易付宝支付密码
信用卡 还款 ， 名字 错 了 ， 款 怎么 还 没 退回来 ？	__label__信用卡还款
易付宝 支付 密码 怎么 修改	__label__易付宝支付密码
不能 用 支付宝 吗 ？	__label__支付
为什么 每个 月 都 给我发 短信 提醒 我 还款 信用卡	__label__信用卡还款
自动扣款 失败 怎么办 ？	__label__任性付
忘记 密码   登陆 不上	__label__易付宝账户
零钱宝 提 的 钱 为什么 还 没有 到   不是 30 分钟 快速 到 账 吗 ？	__label__零钱宝
账号 冻结 怎么办	__label__易付宝账户解冻
已经 变现 成功 了 ， 为什么 还有 应付 利息	__label__理财
任性贷 是 什么	__label__任性贷
货到付款 ， 可以 微信 付款 吗	__label__支付
修改 手机号码 在 哪 修改	__label__易付宝修改绑定手机号码
委托 提现 如何 开通	__label__企业易付宝
咨询 绑定 手机 新增 或 修改 绑定 手机	__label__企业易付宝
请问 零钱宝 存入 资金 后 如何 计息	__label__零钱宝
绑定 的 银行卡 不用 了 ，   怎么办	__label__企业易付宝
我 怎么 可以 更改 手机号	__label__易付宝修改绑定手机号码
我 钱 扣 了 ， 话费 为什么 没到 账	__label__话费
清空 实名认证 的 信息	__label__易付宝实名认证
有 什么 贷款 途径	__label__任性贷
实名认证 时 银行 账户 预留 的 手机号 需要 与 注册 时 填写 的 手机号 保持一致 吗 ？	__label__任性付
请问 礼品 卡能 开 什么 名目 ？	__label__礼品卡
任性付 有 哪些 还款 途径 ？	__label__任性付
购买 的 基金 怎么 一直 受理	__label__理财
任性贷 还款 操作 方式 是 什么	__label__任性贷
怎么 下载 任性付 ？	__label__任性付
有没有 支付宝 的 付款 方式	__label__支付
苏宁 卡是 一次性 消费 还是 可以 分开	__label__礼品卡
七日 年化 收益率 是 什么 意思	__label__零钱宝
怎么 不 可以 到付	__label__支付
为什么 还 没到 账	__label__转账
企业 易付宝 支付 密码 忘记 了 ， 怎么 找回	__label__企业易付宝
提现 还 不到 啊	__label__易付宝账户
现在 不 可以 用 支付宝 支付 吗	__label__支付
买 商品 在 哪里 分期	__label__支付
零钱宝 转 出 原则	__label__零钱宝
苏宁 卡 一次 可以 用 几张	__label__礼品卡
零钱宝 转入 有 限额 吗	__label__零钱宝
申请 任性付 要 很多 材料 吗 ？	__label__任性付
提现 还 没有 到 账	__label__企业易付宝
我 想 同时 购买 两件 商品 ， 可以 在 购物车 合并 后 使用 任性付 支付 吗 ？	__label__任性付
凭 什么 要 上报 征信 ？	__label__任性付
转账 什么 时候 到 账	__label__转账
怎么 从 银行卡 里 转 大额 资金 到 零钱宝 啊	__label__零钱宝
我 在 苏宁 门店 购物 ， 如何 使用 任性付 付款 ？	__label__任性付
什么 是 账单 ?	__label__任性付
易付宝 余额 如何 提现	__label__易付宝账户
账号 解冻	__label__易付宝账户解冻
怎么 我 的 任性贷 付 不了 款 了	__label__任性贷
不是 自己 的 银行卡 可以 支付 吗	__label__支付
超出 月 支付 限额 怎么办 ？	__label__支付
我 的 账户 正常 使用 被 告知 有 风险 冻结 了	__label__易付宝账户解冻
申请 任性付 的 方式 有 哪些 ？	__label__任性付
请问 银行卡 怎么 解绑	__label__易付宝绑定解绑银行卡
设置 了 委托 提现 规则 ， 银行 账户 却 没有 在 规定 时间 收到 资金 转入 ？	__label__企业易付宝
零钱宝 安全性	__label__零钱宝
准备 买个 碎 屏险	__label__延保
任性付 借款 限额 是	__label__任性付
提前 变现 需要 支付 多少 费用	__label__理财
什么 是 实名认证 ？	__label__任性付
在线 支付 可以 使用 信用卡 支付 吗	__label__支付
你们 任性贷 可以 借款 吗	__label__任性贷
密保 问题 忘记 了 ， 怎么办	__label__企业易付宝
我 可以 同时 持有 二个 基金 吗	__label__零钱宝
充 流量 怎么 这么 慢	__label__流量
企业 易付宝 在 什么 地方 登录	__label__企业易付宝
什么 原因 没有 通过	__label__任性贷
批量 付款 到 账 时间	__label__企业易付宝
如何 注销 账号	__label__易付宝注销
任性付 申请 后 多长时间 可以 知道 结果 ？	__label__任性付
任性付 账单 日 可以 修改 吗	__label__任性付
任性贷 一定 要 本人 申请 么	__label__任性贷
正常 贷款 和 逾期 贷款 自动扣款 时间 是 几点 ？	__label__任性付
任性贷 逾期 还款 罚息 多少	__label__任性贷
任性贷 借款 500 元 还 没有 到 账	__label__任性贷
变现 失败 ， 什么 原因 ？	__label__理财
企业 零钱宝 是 什么	__label__企业易付宝
支付宝 超额 不能 支付 ， 怎么办	__label__支付
如何 更换 绑定 手机号码	__label__企业易付宝
不 可以 货到付款 吗	__label__支付
企业 易付宝 如何 登录	__label__企业易付宝
正常 名 认证 打款 什么 时候 到 账	__label__企业易付宝
理财产品 购买 后 一般 几天 开始 生效	__label__理财
能 重新 填写 个人信息	__label__易付宝实名认证
零钱宝 可以 购物 吧	__label__零钱宝
零钱宝 怎么 转入 不了	__label__零钱宝
账户 安全 险 ， 怎么 续保	__label__账户安全险
网银 如何 支付	__label__支付
信用卡 还款 限额 是 多少	__label__信用卡还款
零钱宝 最大 份额 是 多少	__label__零钱宝
零钱宝 会 赔付 本金 吗	__label__零钱宝
变现 后 多久 可以 到 账	__label__理财
怎么 解绑 易付宝	__label__易付宝账户
实名认证 在 哪个 界面 操作	__label__易付宝实名认证
用微 信能 支付 吗 ？	__label__支付
什么 是 实名认证 ？	__label__任性付
哪些 门店 支付 办理 任性贷	__label__任性贷
能 货到付款 吗	__label__支付
买 了 理财 能否 随时 将 钱 转出	__label__理财
新 客户 通过 任性付 APP 申请 额度 需要 提供 哪些 资料 ？	__label__任性付
任性付 的 申请 条件 有 哪些 ？	__label__任性付
如何 激活 易玺	__label__易玺
不满 18 可以 申请 任性付 吗 ？	__label__任性付
任性贷 还款 日 没有 对应 日期 怎么办	__label__任性贷
账户 安全 险保 理财 吗	__label__账户安全险
未 到期 提前 变现 部分 资金 如何 按 什么 利率 计息	__label__理财
变现 成功 资金 到 哪里	__label__理财
任性付 不 支持 买 哪些 商品 ？	__label__任性付
易付宝 充值 什么 时候 到 账	__label__易付宝账户
高级 认证 审核 需要 多长时间	__label__易付宝实名认证
我 想 同时 购买 两件 商品 ， 可以 在 购物车 合并 后 使用 任性付 支付 吗 ？	__label__任性付
怎么 确认 份额	__label__理财
原来 手机号 不用 了 申请 修改	__label__企业易付宝
我 在 苏宁易购 网上 购物 ， 如何 使用 任性付 付款 ？	__label__任性付
购买 苏宁 礼品 卡 实体 卡 大概 多久 能 送到 ？	__label__礼品卡
为什么 我 在 申请 任性贷 时 人脸识别 一直 失败	__label__任性贷
怎么 解绑 银行卡	__label__易付宝绑定解绑银行卡
任性贷 的 可用 额度 突然 变为 0 ， 页面 显示 冻结	__label__任性贷
请问 礼品 卡能 开发票 吗	__label__礼品卡
提现 未到 帐	__label__企业易付宝
易付宝 余额 支付 限额 多少	__label__易付宝账户
任性贷 产品 费率 怎么 计算	__label__任性贷
理财 变现 到 账 哪个 账户 ？	__label__理财
我要 实名认证 怎么 做	__label__任性付
零钱宝 里 的 基金 注册 的 时候 不 小心 点成 别的 了 ， 我 想 换成 广发 的 ， 怎么 搞	__label__零钱宝
定期 转 是否 有 短信 提醒	__label__转账
门店 付款 在 哪 选择	__label__支付
信用卡 不 可以 分期 吗	__label__支付
账单 周期 是 多长 ？	__label__任性付
请问 这个 高级 实名认证 需要 多长时间	__label__易付宝实名认证
任性付 账单 日 可以 修改 吗	__label__任性付
密码 不 对 怎么办	__label__企业易付宝
合并 报送 后会 有 什么 好处 ？	__label__任性付
任性付 逾期 后 如何 还款	__label__任性付
有钱 借 吗	__label__任性贷
我 想要 解绑 银行卡	__label__易付宝绑定解绑银行卡
我 买 的 电器 ， 想加个 延保 ， 怎么 办理	__label__延保
急 需要 账户 冻结 怎么办 ？	__label__任性付
苏宁 购物 支持 哪些 付款 方式 呢 ？	__label__支付
手机 不 使用 了 ， 修改 需要 什么 信息	__label__易付宝修改绑定手机号码
我 忘记 了 支付 密码	__label__易付宝支付密码
app 登陆 页面 的 手势 密码 ， 在 哪里找	__label__易付宝账户
实名认证 怎么 操作	__label__任性付
申请 任性贷 总是 提示 人脸识别 不 通过	__label__任性贷
用非 本人 储蓄卡 网银 充值 行 吗	__label__支付
怎么 企业 汇款	__label__企业易付宝
话费 充错 ， 怎么办	__label__话费
注销 账号 后 是不是 所有 个人信息 都 清除 了	__label__易付宝注销
是不是 别人 的 卡转 不到 钱到 零钱宝 ？	__label__零钱宝
话费 怎么 还 没有 到 账	__label__话费
怎么 申请 任性贷 提额 ？   还是 只能 系统 自动 判定	__label__任性贷
任性付 可以 选择 分 几期 ？	__label__任性付
我 申请 了 借款 ， 审核 了 两天 了 怎么 还是 在 审核	__label__任性贷
企业 易付宝 绑定 手机 可以 更换 吗	__label__企业易付宝
转入 零钱宝 后 收益 怎么 计算	__label__零钱宝
理财 到期 钱 怎么 变现	__label__理财
任性付 有 哪些 分期 还款 方式 ？	__label__任性付
咨询 账户 类型 的 选择	__label__企业易付宝
企业 零钱宝 如何 转入	__label__企业易付宝
没有 出现 解除 银行卡 的 功能	__label__企业易付宝
苏宁 卡 发票 什么 时候 能 邮寄 过来	__label__礼品卡
咨询 修改 企业 名称	__label__企业易付宝
任性贷 收费标准 是 什么	__label__任性贷
为什么 没有 微信 支付 呢	__label__支付
使用 任性付 后 多少 钱 可以 办 分期 啊 ？	__label__任性付
任性付 申请 失败 怎么办 ？	__label__任性付
换 基金 有没有 费用	__label__零钱宝
任性贷 有 额度 提 不 出来	__label__任性贷
解绑 和 换邦 的 限制 条件	__label__易付宝账户
请问 在 哪 可以 查 到 历史 收益 ？	__label__零钱宝
任性 借 多久 到 账 ？	__label__任性付
在 哪里 可以 申请 任性付 额度 ？	__label__任性付
支付 密码 错误 已经 锁定 了	__label__易付宝支付密码
任性贷 逾期 还款 有 什么 后果	__label__任性贷
如何 使用 组合 支付	__label__支付
如何 开通 任性付	__label__任性付
转账 可以 使用 银行卡 支付 吗	__label__转账
怎么 进行 指纹 支付	__label__易付宝支付密码
咨询 实名认证 原因	__label__企业易付宝
通讯录 转账 什么 意思	__label__转账
理财 什么 时候 到 账	__label__理财
什么 是 账单 ?	__label__任性付
为什么 支付宝 付款 不 可以	__label__支付
如何 购买 苏宁 卡	__label__礼品卡
我用 购物 卡买 的 单 ， 已经 退货 。 是 退回 购物 卡 还是 易付宝 ？ 或者 银行卡 ？	__label__礼品卡
提前 变现 利息 怎么 结算	__label__理财
修改 手机号码	__label__易付宝修改绑定手机号码
支付 时 没有 显示 任性贷	__label__任性贷
任性付 是否 需要 明确 具体 用途 ？	__label__任性付
盗抢 碎 屏保 是 怎么回事	__label__延保
提现 还 没有 到 账	__label__易付宝账户
为啥 不能 注销 帐号	__label__易付宝注销
付款 方式 改为 微信 支付	__label__支付
易付宝 账户 怎么 注销	__label__易付宝注销
提现 多长时间 到 帐	__label__易付宝账户
如何 开通 委托 提现 ？	__label__企业易付宝
碎 屏险 怎么 买	__label__延保
如何 使用 任性付 ？	__label__任性付
怎么 分期 支付 ？	__label__支付
高级 认证 的 时间 是 多长	__label__易付宝实名认证
如何 清空 实名认证 的 信息	__label__易付宝实名认证
我 的 易玺 激活 不了	__label__易玺
易付宝 账户 怎么 注销 不了	__label__易付宝注销
如何 修改 任性付 绑定 的 手机号码 ？	__label__任性付
我 充值 的 话费 ， 怎么 给 我 发票	__label__话费
任性付 上报 的 征信 是否 经过 客户 同意 ？	__label__任性付
账户 设置 了 免 支付 密码 支付 ， 怎么 取消 呢	__label__易付宝支付密码
理财券 怎么 兑换	__label__理财
在线 怎么 付款	__label__支付
能 不能 支付宝 或是 微信 付款	__label__支付
易付宝 是不是 要 下载 的	__label__易付宝账户
怎么 选择 不了 苏宁 卡 支付	__label__支付
任性付 有 哪些 还款 渠道	__label__任性付
理财 保本 吗 ， 属于 什么 风险 级别	__label__理财
买个 理财产品 变现 后 发现 到期 时该 产品 不能 支付 了   和 我 有没有 关系	__label__理财
我 刚刚 还款 信用卡 ， 卡号 输错 了 ， 什么 时候 退回	__label__信用卡还款
任性贷 借款 显示 放款 中	__label__任性贷
问 一下 我 申请 任性贷 好 几天 啦 ， 怎么 还 没 回复 啊	__label__任性贷
如何 使用 和 包 支付	__label__支付
票据 理财 都 几点 抢	__label__理财
快捷 支付 怎么 解绑	__label__易付宝绑定解绑银行卡
刚 把 产品 变现 ， 现在 想 撤回 怎么办	__label__理财
如何 进行 实名认证 ？	__label__任性付
有 任性付 贷款 记录 就 不能 办理 银行贷款 了 ？	__label__任性付
任性付 账单 日 一般 什么 时候	__label__任性付
在 哪里 可以 申请 任性贷	__label__任性贷
定期 变现 ， 这么 原来 的 利息 没有 了 呀	__label__理财
没有 在 还款 账户 里 存入 足够 的 金额 ， 我司 不予 扣款 还是 有 多少 扣 多少 ？	__label__任性付
转账 不 成功 不知 什么 原因	__label__转账
营业执照  身份证 即将 到期 或 已经 过期	__label__企业易付宝
任性付 的 起贷 额度 是 多少 ？	__label__任性付
我要 修改 手机号码	__label__任性付
高级 认证 怎么 操作	__label__易付宝实名认证
我 余额 支付 怎么 超额 了	__label__易付宝账户
任性付 手续费 收取 标准 是 什么 ？	__label__任性付
原来 账户 邮箱 号码 不 在 使用 ， 账户 怎么 修改	__label__企业易付宝
合并 报送 后会 有 什么 好处 ？	__label__任性付
任性贷 放款 失败	__label__任性贷
意外 保障 和 延长 保修 有 什么 区别	__label__延保
提示 密码 错误 ，   忘记 了	__label__企业易付宝
易付宝 如何 提现	__label__易付宝账户
零钱宝 中 显示 的 收益 是 当天 吗	__label__零钱宝
任性付 逾期 会 影响 个人信用 吗 ？	__label__任性付
苏宁 卡 过期 了 怎么办	__label__礼品卡
信用卡 分期 怎么 分	__label__支付
可以 把 货到付款 改成 在线 支付 吗 ？	__label__支付
使用 任性付 会 不会 影响 银行 放 贷款 ?	__label__任性付
手机号 换 了	__label__易付宝修改绑定手机号码
什么 是 最低 还款额 ？	__label__任性付
企业 汇款 到 账 时间	__label__企业易付宝
易玺 如何 购买	__label__易玺
任性付 账单 最低 还款额 后 剩余 本金 如何 收费 ？	__label__任性付
我 没 身份证号 无法 认证 ， 怎么 解决	__label__易付宝实名认证
零钱宝 在 账户 安全 险 保障 范围 么	__label__账户安全险
理财 还款 情况	__label__理财
为什么 任性贷 额度 变成 了 0 呢	__label__任性贷
申请变现 一般 多少 时间 到 账	__label__理财
任性付 借款 有 限额 吗 ？	__label__任性付
我 在 苏宁易购 网上 购物 ， 如何 使用 任性付 付款 ？	__label__任性付
提现 小于 5 万 的 能 成功 ， 但 大于 5 万 的 提现 总是 失败 怎么办 ？	__label__企业易付宝
你好 ， 我存 了 钱 怎么 一分 都 没长 啊	__label__零钱宝
如何 操作 变现	__label__理财
我 有 特殊 原因 不能 按时 还款 ， 可不可以 申请 宽限期	__label__任性贷
我 想 删除 支付 时候 绑定 的 银行卡   如何 操作	__label__易付宝绑定解绑银行卡
使用 任性付 时 可以 用 其他 优惠券 吗 ？	__label__任性付
零钱宝 转出 是 多少	__label__零钱宝
购买 的 苏宁 卡 和 发票 什么 时候 到	__label__礼品卡
修改 绑定 手机 多久 审核	__label__易付宝修改绑定手机号码
怎么 修改 账户 的 密保 问题	__label__企业易付宝
零钱宝 只能 用 储蓄卡 吗	__label__零钱宝
购买 的 理财 什么 时候 到期	__label__理财
什么 是 企业 汇款	__label__企业易付宝
转账 限额	__label__转账
固定 理财 还 没 募集 成功 我 可以 退 吗	__label__理财
如果 任性付 自扣 失败 怎么办 ？	__label__任性付
理财 怎么 购买	__label__理财
理财 什么 时候 到期	__label__理财
帐户 安全 险 到期 了 可以 续保 吗 ？	__label__账户安全险
为什么 要求 企业 易付宝 账户 实名认证	__label__企业易付宝
零钱宝 今天 转入 几时 收益 ？	__label__零钱宝
实名认证 的 具体步骤	__label__企业易付宝
自动扣款 失败 怎么办 ？	__label__任性付
委托 提现 每天 提现 多少 次 ？ 委托 提现 的 限额 是 多少 ？	__label__企业易付宝
我想 延保	__label__延保
零钱 还 信用卡 ， 还错 账户 了 ， 怎么办	__label__信用卡还款
如何 开启 小额 免密	__label__易付宝支付密码
账号 挂失 是 什么	__label__易付宝账户
提现 的 到 现在 还 没到	__label__易付宝账户
如何 开启 小额 免密	__label__易付宝支付密码
什么 是 易玺	__label__易玺
任性付 怎么 用 啊 ？	__label__任性付
怎么 用 苏宁 卡 支付	__label__支付
货到付款 可以 微信 支付 吗 ？	__label__支付
任性付 的 起贷 额度 是 多少 ？	__label__任性付
任性贷 还款 是 线 上 操作 的 吗	__label__任性贷
卡里 有钱 为什么 任性贷 自动 代扣 还会 失败	__label__任性贷
外籍 企业法人 实名认证	__label__企业易付宝
易付宝 账号 如何 解挂	__label__易付宝账户
转账 在 哪	__label__转账
易付宝 账号 如何 注册	__label__易付宝账户
任性贷 支付 不了 ， 怎么回事	__label__任性贷
如何 找回 任性付 app 端 支付 密码 ？	__label__任性付
怎么 修改 易付宝 绑定 手机	__label__易付宝修改绑定手机号码
变现 需要 收取 手续费 吗	__label__理财
易付宝 余额 提现 得 多久	__label__易付宝账户
任性贷 如何 提高 额度	__label__任性贷
哪些 银行卡 可以 作为 实名认证 的 绑定 卡 ？	__label__任性付
一个 身份证号 可以 绑定 几个 任性付 账户 ？	__label__任性付
任性贷 脸 一直 扫 不 进去	__label__任性贷
理财 的 钱 到期 了 ， 怎么 设置 钱 的 转入 方式	__label__理财
为啥 开通 不了 任性贷	__label__任性贷
定期 转	__label__转账
购买 卡 的 发票 可以 开 什么 类别 呢 ？	__label__礼品卡
理财 安全可靠 吗 ？	__label__理财
买 理财 抵扣 券 怎么 来 的	__label__理财
任性付 可以 买 哪些 商品 ？	__label__任性付
固收 类产品 存 多久 可以 转为 可 变现	__label__理财
可以 使用 和 包 支付 吗	__label__支付
这个 根据 什么 确认 的	__label__理财
易付宝 余额 支付 限额 多少	__label__易付宝账户
零钱宝 钱 不能 全额 转 出	__label__零钱宝
消费 贷款 按 什么 计息	__label__任性贷
充值 话费 充值 成功 后 ， 为什么 充值 失败 了 ？	__label__话费
转账 可以 使用 零钱宝 吗	__label__转账
怎么 解绑 已经 绑定 的 银行卡	__label__企业易付宝
任性付 账单 如何 还款 ？	__label__任性付
任性贷 提现 到 银行卡 失败 怎么回事	__label__任性贷
任性贷 产品 费率 计算 方式	__label__任性贷
为什么 不能 用 支付宝	__label__支付
可以 分期付款 吗	__label__支付
征信 报告 上 如何 显示 我 的 贷款 情况 ？	__label__任性付
怎么 贷款	__label__任性贷
理财 风险 大 吗	__label__理财
理财 的 收益 怎么 计算	__label__理财
高级 认证 需要 哪些 资料	__label__易付宝实名认证
银联 支付 怎么 选择	__label__支付
为啥 不能 用 支付宝 付款 了	__label__支付
易付宝 如何 解冻	__label__易付宝账户解冻
苏宁 都 有 哪些 支付 方式	__label__支付
我 把 钱 存入 了 易付宝 余额 里 ， 什么 时候 自动 代扣	__label__任性贷
如果 提前 变现 ， 有 什么 资金 变化 吗	__label__理财
易付宝 给 信用卡 还款 在 哪里	__label__信用卡还款
零钱宝 收益 何时 可以 显示	__label__零钱宝
苏宁 卡 怎么 使用	__label__支付
定期 转 各种 支付 方式 的 限额 是 多少	__label__转账
新 客户 通过 任性付 APP 申请 额度 需要 提供 哪些 资料 ？	__label__任性付
支付 密码 忘 了 怎么弄	__label__易付宝支付密码
支付 密码 输错 5 次 怎么办	__label__企业易付宝
实名认证 打款 一般 多久 到 账 ？	__label__企业易付宝
一年 碎 屏险 怎么 领	__label__延保
易付宝 充值 什么 时候 到 账	__label__易付宝账户
什么 是 每 万分 收益率	__label__零钱宝
刚买 的 苏宁 卡 ， 啥时候 能 到	__label__礼品卡
任性贷 可以 提额 吗	__label__任性贷
任性贷 产品 费率 标准 是 什么	__label__任性贷
任性贷 借款 什么 时候 到 账 呀	__label__任性贷
怎么 清空 资料	__label__易付宝实名认证
碎 屏险 可以 再加 吗	__label__延保
任性付 哪些 业务 并入 账单 ？	__label__任性付
忘记 易付宝 账户 登录 密码 如何 找回 ？	__label__企业易付宝
为啥 我 提现 还 没到	__label__易付宝账户
理财 是否 保本	__label__理财
账号 解冻 多久 审核	__label__易付宝账户解冻
任性付 是否 支持 提前 还款	__label__任性付
如何 找回 任性付 app 端 登录 密码 ？	__label__任性付
流量 失败 怎么办	__label__流量
企业 汇款 一般 是 几天 到 账	__label__企业易付宝
任性贷 什么 时候 上报 征信	__label__任性贷
把 钱 存入 企业 零钱宝 ， 它 的 收益 怎么 计算 ， 是否 有 亏损	__label__企业易付宝
零钱宝 转出 到 帐 时间	__label__零钱宝
我 钱 扣 了 ， 流量 为什么 还 不到 账	__label__流量
申请 任性付 最高 多少 万 ？	__label__任性付
自动 代扣 的 时间 点 是 什么 时候	__label__任性贷
怎么 修改 法定代表 人 手机号	__label__企业易付宝
任性贷 额度 么 有 了	__label__任性贷
手机号码 怎么 改	__label__任性付
银行卡 的 钱 要 转入 零钱宝 ， 才能 买 定期 理财产品 吗 ?	__label__理财
任性贷 额度 在 门店 刷 不了   是 额度 一直 没用 了 么	__label__任性贷
怎么 修改 企业 易付宝 登陆密码	__label__企业易付宝
我 先前 绑定 的 手机号码 没有 用 了 ， 现在 要 换成 我 新 号码	__label__易付宝修改绑定手机号码
任性贷 在 门店 使用 不了	__label__任性贷
怎么 不 可以 分期	__label__支付
更换 绑定 手机	__label__易付宝修改绑定手机号码
我 怎么 才 可以 存钱 到 零钱宝	__label__零钱宝
如何 开启 指纹 支付	__label__易付宝支付密码
收益 什么 时候 有 显示	__label__理财
零钱宝 一次 最多 转出 多少 钱 ？	__label__零钱宝
能 用 支付宝 吗 ？	__label__支付
收款 方 信息 不 对 怎么办	__label__转账
任性付 合并 上报 多久 上报 一次	__label__任性付
为什么 注销 不了 帐户	__label__易付宝注销
怎么 查询 我 的 征信 报告 ？	__label__任性付
提现 一直 都 没到 账	__label__易付宝账户
易付宝 和 易 购解 绑 和 换邦 有 什么 条件	__label__易付宝账户
能 不能 信用卡 线上 支付	__label__支付
委托 提现 时效	__label__企业易付宝
什么 时候 到款 零钱宝	__label__零钱宝
企业 易付宝 充值 什么 时候 到 账	__label__企业易付宝
我 想 解除 绑定 银行卡 ， 怎么 操作	__label__易付宝绑定解绑银行卡
为何 我 提现 还 没到 账	__label__企业易付宝
怎么 注销 易玺	__label__易玺
任性付 账单 如何 还款 ？	__label__任性付
请问 怎么 解除 易购 帐号	__label__易付宝账户
如何 使用 苏宁 卡 支付	__label__支付
易玺 不 需要 使用 了 ， 申请 注销	__label__易玺
怎么 操作 定期 转	__label__转账
我 就 逾期 一天 ， 怎么 任性贷 额度 显示 为 0	__label__任性贷
任性付 账单 几号 还款 ？	__label__任性付
任性贷 怎么 审核 那么 久	__label__任性贷
实名认证 打款 什么 时候 到 账	__label__企业易付宝
支付 密码 忘记 了 ， 如何 查询 支付 密码	__label__易付宝支付密码
如何 修改 账户 号	__label__企业易付宝
怎样 注销 实名认证	__label__易付宝实名认证
不 记得 任性付 APP 登录 密码 怎么办	__label__任性付
实名认证 ， 身份证 号码 输错 了 ， 怎么 改	__label__易付宝实名认证
易付宝 账号 怎么 解冻	__label__易付宝账户解冻
我 不想 实名认证	__label__任性付
什么 是 通讯录 转账	__label__转账
登陆密码 怎么 找回	__label__易付宝账户
通过 任性付 借款 手续费 怎么 收 ？	__label__任性付
如何 解绑 银行卡	__label__易付宝绑定解绑银行卡
没有 通过 多久 可以 再次 申请 呢	__label__任性贷
申请 的 变现 成功 了 吗 ？ 多久 能 到 账	__label__理财
任性贷 如何 自动 代扣	__label__任性贷
咨询 修改 密码保护 问题	__label__企业易付宝
我 的 任性贷 额度 怎么 没有 了	__label__任性贷
七日 年化 收益率 是 基金 年 收益 吗	__label__零钱宝
为什么 想 通过 银行卡 向 零钱宝 转款 ， 都 变成 了 购买 零钱宝 关联 的 基金 了	__label__零钱宝
任性贷 显示 放款 中	__label__任性贷
任性付 线上 购物 如何 收费 ?	__label__任性付
任性贷 计费 规则 是 什么	__label__任性贷
我 易付宝 冻结 了 咋 解冻 呢	__label__易付宝账户解冻
零钱宝 是否 保本	__label__零钱宝
我 想 借款 5 万 ， 可以 吗	__label__任性贷
苏宁 卡 的 有效期 多久	__label__礼品卡
一般 多久 可以 到 账	__label__企业易付宝
账号 注册	__label__易付宝账户
任性贷 逾期 怎么办	__label__任性贷
苏宁 卡 干嘛 的	__label__礼品卡
你好 ， 零钱宝 提现 多久 到 账	__label__零钱宝
延保 没有 发票 吗 ？	__label__延保
任性贷 开通 需要 多久	__label__任性贷
不是 可以 微信 支付 吗 ！ 怎么 现在 不能 用 呢 ？	__label__支付
零钱宝 的 钱 在 保险 赔付 范围 么	__label__零钱宝
如何 关闭 指纹 支付	__label__易付宝支付密码
我 想 问 一下 变现 的 程序	__label__理财
订单 想 转到 支付宝 支付 怎么 转 ？	__label__支付
怎么 购买 易玺	__label__易玺
请问 怎么 用 信用卡 支付 呢	__label__支付
延保 发票 没有 收到	__label__延保
批量 付款 正常 多久 到 账	__label__企业易付宝
零钱宝 1 天 可取 多少 次 ， 最 多 可取 多少 钱	__label__零钱宝
怎么 注册 易付宝 账号	__label__易付宝账户
如果 24 小时 以后 变现 不 成功 还 可以 继续 变现 么	__label__理财
盗抢险 是 什么	__label__延保
没有 在 还款 账户 里 存入 足够 的 金额 ， 我司 不予 扣款 还是 有 多少 扣 多少 ？	__label__任性付
什么 是 通讯录 转账	__label__转账
如何 开启 指纹 支付	__label__易付宝支付密码
零钱宝 能 支付 或 还款 吗	__label__零钱宝
任性付 可 提前 还款 的 时间 是 ？	__label__任性付
账号 注册	__label__企业易付宝
变现 是否 有 次数 限制	__label__理财
零钱宝 转入 怎么 自动 购了 基金	__label__零钱宝
如果 使用 银联 支付	__label__支付
用 任性贷 到 苏宁易购 买手机 能 不能 分期	__label__任性贷
任性付 最高 贷款额度 是 多少 ？	__label__任性付
零钱宝 怎么 换 基金	__label__零钱宝
在 哪里 可以 申请 任性付 额度 ？	__label__任性付
苏宁 购物 支持 哪些 付款 方式 呢 ？	__label__支付
能 不能不 实名认证	__label__任性付
为什么 充值 不了	__label__话费
购买 的 空调 现在 想 买 延保	__label__延保
不 允许 信用卡 支付 ？	__label__支付
请问 零钱宝 里 的 钱 取到 银行卡 为什么 只能 取 部分	__label__零钱宝
给 信用卡 还款 的 时候 提示 我超 限额	__label__信用卡还款
苏宁 账户 和 苏宁金融 账户 怎么 绑定 在 一起	__label__易付宝账户
如何 修改 激活 信息	__label__易付宝实名认证
任性付 提前 还款 后 费用 如何 收取 ？	__label__任性付
定期 转 的 操作步骤	__label__转账
任性付 额度 可以 重复使用 吗 ？	__label__任性付
任性付 为什么 要 上报 征信 ？	__label__任性付
企业 名称 已经 换 了 ， 怎么 在 企业 易付宝 账户 上 修改	__label__企业易付宝
昨天 的 收益 我 在 哪 看	__label__零钱宝
流量 充值 支付 成功 后 ， 为什么 订单 显示 关闭 了	__label__流量
忘记 支付 密码	__label__易付宝支付密码
提现 多长时间 到 帐	__label__企业易付宝
什么 是 账号 挂失	__label__易付宝账户
任性付 取现 手续费 率 是 多少 ？	__label__任性付
我 的 支付 密码 忘 了	__label__易付宝支付密码
实名 的 时候 如何 写三证 合一 的 信息	__label__企业易付宝
怎么 分期付款	__label__支付
可以 用网 银 转账 吗	__label__转账
信用卡 分期 有 免息 吗	__label__支付
想 用 支付宝 支付 ， 怎么 操作	__label__支付
批量 付款 具体步骤	__label__企业易付宝
转帐 信息 错 了 能 退款 吗	__label__转账
我 想 把 你们 平台 信用卡 还款 提醒 关闭 ， 怎么 关	__label__信用卡还款
零钱宝 转入 本金 总额 有 限制 吗	__label__零钱宝
我 的 流量 充值 订单 失败 了	__label__流量
理财 什么 时候 起息	__label__理财
购买 的 基金 什么 时候 可以 确认	__label__理财
零钱宝 可以 还款 吗	__label__零钱宝
手机 充值 后 如何 获取 发票 ？	__label__流量
使用 任性付 会 不会 影响 其他 银行贷款 的 申请 ？	__label__任性付
随借 随 还 如何 还款 ？	__label__任性付
定期 转 什么 意思	__label__转账
如何 修改 易付宝 登录 密码	__label__易付宝账户
转账 可以 使用 什么 方式 支付	__label__转账
怎么 修改 登陆密码	__label__易付宝账户
如何 关闭 指纹 支付	__label__易付宝支付密码
银行卡 怎么 解绑	__label__易付宝绑定解绑银行卡
易付宝 账号 如何 挂失	__label__易付宝账户
如何 绑定 银行卡	__label__易付宝绑定解绑银行卡
我 现在 存 ， 什么 时候 才 会 有 收益	__label__零钱宝
易付宝 被 冻结 了   已经 提交 申请   什么 时候 能够 审批 过关	__label__易付宝账户解冻
任性贷 如何 还款	__label__任性贷
什么 是 易付宝	__label__易付宝账户
如何 取消 变现	__label__理财
理财券 如何 兑换	__label__理财
理财 都 几点 抢 啊	__label__理财
合并 上报 周期 是 多长 ？	__label__任性付
可以 用到 下个月 吗 ？	__label__流量
任性付 免息期 多长 ？	__label__任性付
易玺 激活 失败	__label__易玺
定期 理财 变现 ， 周末 可以 当天 到 账 吗	__label__理财
易付宝 转入 时 提示 交易 金额 超 限制	__label__易付宝账户
怎么 登陆 不了 APP	__label__易付宝账户
我要 注销 易玺	__label__易玺
怎样 重设 支付 密码	__label__企业易付宝
理财 是 哪边 担保	__label__理财
企业 易付宝 如何 充值	__label__企业易付宝
咨询 修改 法定代表 人 手机号	__label__企业易付宝
我 的 账号 别人 的 信息 实名 ，   我 如何 申诉	__label__易付宝实名认证
易付 冻结 ， 不 知道 怎么 解冻	__label__易付宝账户解冻
申请 任性付 没有 通过 ， 要 多久 才能 再次 申请 ？	__label__任性付
任性贷 还款 支持 两个 账户 分别 扣款 合并 还款 吗	__label__任性贷
零钱宝 可以 同时 有 几个 基金	__label__零钱宝
在 APP 修改 支付 密码 怎么 操作	__label__易付宝支付密码
我 申请 了 ， 可是 一直 没有 额度 呢	__label__任性贷
企业 易付宝 如何 绑定 银行卡	__label__企业易付宝
我 想 取消 账户 银行卡	__label__企业易付宝
任性付 上报 征信 没有 经过 我	__label__任性付
哪里 办理 任性付 ？	__label__任性付
我 需要 解绑 银行卡	__label__易付宝绑定解绑银行卡
理财 上线 时间	__label__理财
变现 以后 之前 的 收益 怎么办	__label__理财
理财 里 的 可 变现 是 什么 意思	__label__理财
通讯录 转账 是 啥	__label__转账
任性付 逾期 违约金 如何 收取 ？	__label__任性付
请问 可 变现 的 产品 如何 变现 ？	__label__理财
去 门店 分期 一个月 要收 多少 利息	__label__任性贷
没有 填写 汇款 识别码 ， 会 不会 有 什么 问题	__label__企业易付宝
为什么 要 看 万分 收益	__label__零钱宝
为什么 任性贷 几天 了 都 还 没有 通过 ？	__label__任性贷
任性付 可以 用于 购房 、 买车 吗 ？	__label__任性付
怎么 修改 企业 易付宝 绑定 手机	__label__企业易付宝
我 之前 的 手机号码 没有 ， 怎么 更改 呢	__label__企业易付宝
我 提现 这么 长时间 怎么 还 没到 账	__label__企业易付宝
怎么 修改 密保 问题	__label__企业易付宝
能 不能 帮 我 解冻 易付宝 账号	__label__易付宝账户解冻
账号 安全 险快 到期 了 ， 该 怎么 继保	__label__账户安全险
付款 的 时候 为什么 说 账户 被 冻结	__label__易付宝账户解冻
充值 话费 什么 时候 到 账 ?	__label__话费
为什么 转入 不了 零钱宝 了	__label__零钱宝
任性付 账单 最低 还款额 后 剩余 本金 如何 收费 ？	__label__任性付
账号 挂失	__label__易付宝账户
批量 付款 如何 操作步骤	__label__企业易付宝
苏宁 卡是 永久 使用 的 吗	__label__礼品卡
高级 实名认证 审核 需要 多久	__label__易付宝实名认证
如何 解绑 银行卡	__label__易付宝绑定解绑银行卡
购物 分期 、 任性 借 每月 等额 和 先费 后本 选择 期数 分别 是 多少 ？	__label__任性付
那个 存入 基金 有钱 的 是 什么 名字	__label__零钱宝
任性付 的 购物 贷款 支持 哪些 商品 ？	__label__任性付
没有 易付宝 不能 支付 吗	__label__支付
易付宝 和 易 购解 绑 流程	__label__易付宝账户
想要 修改 登陆密码	__label__易付宝账户
为什么 我 的 账户 好端端 被 冻结 了 呢	__label__易付宝账户解冻
任性付 购物 贷款 享受 不 分期 免息 后 是否 可以 分期 ？	__label__任性付
转账 怎么 还 没有 到 账	__label__转账
通过 任性付 借钱 后 什么 时候 到 账 ？	__label__任性付
支付 就 自动 扣钱 了 ， 怎么 关闭	__label__易付宝支付密码
为什么 任性付 通过 不了 啊 ？	__label__任性付
为什么 我 信用卡 已经 还款 了 ， 你们 还 发短信 提醒 我 还款	__label__信用卡还款
一直 没有 办法 付款   提示 账户 被 冻结	__label__易付宝账户解冻
在 哪边 可以 选择 和 包 支付	__label__支付
易玺 激活 步骤	__label__易玺
任性贷 为什么 借款 失败	__label__任性贷
随借 随 还 支持 部分 还款 吗 ？	__label__任性付
什么 是 苏宁 卡 ？	__label__礼品卡
账户 安全 险 保障 我 哪些 资金	__label__账户安全险
为什么 定金 不能 用 支付宝	__label__支付
委托 提现 设置 后 可以 修改 委托 提现 或者 提现 规则 吗 ？	__label__企业易付宝
更换 基金 收益 是否 有 损失	__label__零钱宝
可以 注销 易玺 么	__label__易玺
变现 之前 的 收益 如何 计算	__label__理财
卡号 输错 怎么办	__label__转账
苏宁 卡是 什么 意思	__label__礼品卡
任性贷 提现 失败	__label__任性贷
变现 手续费 多少	__label__理财
理财 预约 还 没有 成功	__label__理财
购买 短期 的 理财产品 ， 保本 的 ， 有 啥 好 推荐	__label__理财
可以 用 易付宝 还款 任性贷 吗	__label__任性贷
有没有 保本 型 理财	__label__理财
为什么 我 帐户 冻结	__label__易付宝账户解冻
什么 是 任性贷	__label__任性贷
任性付 是否 可以 提前 还款 ？	__label__任性付
零钱宝 可以 还款 信用卡 吗	__label__信用卡还款
为什么 要 实名认证	__label__任性付
实名认证 的 时候 修改 不了 姓名	__label__易付宝实名认证
我要 把 这个 实名认证 去掉	__label__易付宝实名认证
快捷方式 一次 能 最 多 转 多少 钱到 零钱宝 ？	__label__零钱宝
什么 是 最低 还款额 ？	__label__任性付
任性付 账单 还 完 最小 还款额 怎么 收费 ？	__label__任性付
定期 转 的 任务 能 删除 吗	__label__转账
什么 是 合并 上报 征信 ？	__label__任性付
提现 多久 到 账	__label__企业易付宝
如何 修改 企业 名称	__label__企业易付宝
账户 怎么 注销	__label__易付宝注销
实名 如何 取消	__label__易付宝实名认证
有没有 限额	__label__转账
在 哪里 申请 办理 任性付	__label__任性付
任性付 账单 最低 还款额 如何 计算 ？	__label__任性付
企业 采购 苏宁 卡 ， 发票 能 开 礼品 或者 是 办公用品 吗 ？	__label__礼品卡
为什么 不能 用 支付宝 或者 微信付	__label__支付
提现 到 现在 没有 到 账 是 什么 原因	__label__企业易付宝
任性付 的 申请 条件 有 哪些 ？	__label__任性付
可 变现 利息 怎么 算	__label__理财
任性贷 需要 多久 时间 开通	__label__任性贷
企业 汇款 未到 账	__label__企业易付宝
零钱 和 支付宝 一样 吗	__label__零钱宝
理财 到期 后 资金 到 银行卡 吗	__label__理财
什么 是 定期 转	__label__转账
变 现钱 是 到 银行卡 吗	__label__理财
我 想 删除 支付 时候 绑定 的 银行卡   如何 操作	__label__企业易付宝
任性付 账单 中 不 分期 贷款 收费 吗 ？	__label__任性付
任性贷 还款 日 是 几号	__label__任性贷
港澳台 同胞 是否 能 申请 任性付 ？	__label__任性付
苏宁 卡 可以 转给 其他人 吗 ？	__label__礼品卡
易玺 无法 正常 激活	__label__易玺
怎么 还 没 提现 成功	__label__企业易付宝
手机 充值 后 如何 获取 发票 ？	__label__话费
我 想 查询 我 的 征信 报告 ， 怎么 查 ？	__label__任性付
延保 怎么 买	__label__延保
易玺 激活 失败	__label__易玺
在 门店 付款 显示 交易 存在 风险	__label__任性贷
实名认证 怎么 更改	__label__易付宝实名认证
任性付 端 如何 开通 南京 银行 电子 账户 ？	__label__任性付
为什么 花呗 、 京东白条 就 不 上报 征信 ？	__label__任性付
合并 上报 征信 是 什么 意思 ？	__label__任性付
企业 汇款 没有 冲进去	__label__企业易付宝
任性付 何时 可 提前 结清 ？	__label__任性付
转入 零钱宝 的 上限 是 多少	__label__零钱宝
我 的 易付宝 什么 时候 可以 给 我 解冻	__label__易付宝账户解冻
什么 是 批量 付款 至 银行 账户 ， 批量 付款 至 银行 账户 的 流程	__label__企业易付宝
随借 随 还 如何 收取 费用 ？	__label__任性付
苏宁易购 买 东西 可以 用 信用卡 付款 吗	__label__支付
手机 上能 不能 导出 零钱宝 明细	__label__零钱宝
不能 微信 和 支付宝 支付	__label__支付
不 可以 组合 支付 了 吗	__label__支付
任性付 的 还款 规则 是 什么 ？	__label__任性付
产品 收益 如何 计算	__label__理财
企业 买 苏宁 卡   给 开发票 么	__label__礼品卡
七日 年化 收益率 怎么 算 的	__label__零钱宝
任性付 实名认证 中 可以 绑定 哪些 银行 发行 的 银行卡 ？	__label__任性付
使用 任性付 借钱 后 钱 怎么 给 我 ？	__label__任性付
登陆密码 如何 修改	__label__易付宝账户
任性贷 代扣 失败 的 原因 有 哪些	__label__任性贷
如何 分期	__label__支付
任性付 可以 用于 购房 、 买车 吗 ？	__label__任性付
企业 汇款 的 时效 是 什么	__label__企业易付宝
1.99 元 的 投保 是 保障 资金 安全 吗 ？	__label__账户安全险
如何 注册 企业 易付宝	__label__企业易付宝
任性贷 昨天 还有 额度 ， 今天 为什么 显示 为 0	__label__任性贷
苏宁 卡 不 可以 缴费 ?	__label__支付
修改 绑定 手机 多久 审核	__label__易付宝修改绑定手机号码
为什么 任性贷 自动 代扣 失败 了	__label__任性贷
取 现在 怎么 不到 账	__label__易付宝账户
我 的 任性付 绑定 的 银行卡 可否 更换 ？	__label__任性付
企业 易付宝 绑定 手机号码 怎么 更改	__label__企业易付宝
取消 绑定 的 银行卡	__label__企业易付宝
为什么 我 提现 转账 还 没到	__label__易付宝账户
苏宁 卡 可以 转让 吗	__label__礼品卡
任性付 逾期 后 额度 无法 使用 怎么办 ？	__label__任性付
货到付款 支持 支付宝 吗	__label__支付
信用卡 还款 ， 信息 填错 了 能 撤销 吗	__label__信用卡还款
话费 充值 支付 成功 后 ， 为什么 订单 显示 关闭 了	__label__话费
刷 脸 不 成功	__label__任性贷
我 忘记 了 企业 易付宝 支付 密码	__label__企业易付宝
企业 易付宝 余额 提现 得 多久	__label__企业易付宝
易付宝 账号 如何 解挂	__label__易付宝账户
如何 快捷 支付	__label__支付
什么 是 账单 日 ， 账单 日 是 几号 ？	__label__任性付
如何 找回 企业 易付宝 支付 密码	__label__企业易付宝
任性付 还款 时间 是 ？	__label__任性付
任性贷 怎么 提升 额度	__label__任性贷
任性付 端 如何 开通 南京 银行 电子 账户 ？	__label__任性付
请问 我 申请 提现 的 任性贷 为什么 迟迟 不到 账	__label__任性贷
怎么 修改 手机号码	__label__任性付
可以 注销 账户 吗	__label__易付宝注销
为什么 我 的 银行卡 绑定 不了	__label__易付宝绑定解绑银行卡
如何 开通 快捷 ？	__label__支付
高级 认证 需要 哪些 资料	__label__易付宝实名认证
怎么 解绑 银行卡	__label__企业易付宝
个人信息 里 的 名字 怎么 修改	__label__易付宝实名认证
任性付 逾期 是否 会 影响 个人信用	__label__任性付
理财 保本 吗	__label__理财
任性贷 逾期 罚息 怎么 收 的	__label__任性贷
易玺 怎么 不能 用	__label__易玺
账号 说 临时 冻结 了	__label__易付宝账户解冻
换 基金 有 损失 吗	__label__零钱宝
客户 使用 任性付 分期 购物 ， 在 首次 还款 日前 ， 未 还款 退货 ， 资金 如何 处理 ？	__label__任性付
不 支持 支付宝 付款 吗	__label__支付
使用 信用卡 付款 要 怎么 选择 分期	__label__支付
零钱宝 支持 , 微信 转入 吧	__label__零钱宝
任性贷 还款 可以 自动 代扣 吗	__label__任性贷
我们 平时 看 万分 收益 还是 年化 收益	__label__零钱宝
实名认证 支持 哪些 银行卡	__label__企业易付宝
为什么 我 的 任性贷 开通 不了	__label__任性贷
实名认证 有 什么 好处	__label__任性付
任性付 在 哪里 使用 啊 ？	__label__任性付
任性付 非 账单 贷款 业务 还款 日 是 ？	__label__任性付
流量 充值 成功 后 ， 为什么 充值 失败 了 ？	__label__流量
任性付 提供 哪些 还款 服务 ？	__label__任性付
零钱宝 支付 有 限额 吗 , 还款 有 吗	__label__零钱宝
可 变现 怎么 标准	__label__理财
什么 是 企业 零钱宝	__label__企业易付宝
I 类 账户 不能 提现 1000 元 以上	__label__易付宝账户
我 的 任性付 贷款 逾期 多期 ， 如何 还款 ？	__label__任性付
如何 操作 批量 付款	__label__企业易付宝
支付 密码 是 什么	__label__易付宝支付密码
怎么 才能 变现 呢	__label__理财
变现 怎么 都 要 少 金额 呢	__label__理财
任性贷 钱 不够 可以 提额 吗	__label__任性贷
充值 后 的 流量 可以 累计 到 下个月 吗 ？	__label__流量
原卡 注销 情况 下 转出	__label__零钱宝
任性付 逾期 后 如何 还款	__label__任性付
我 想 更换 银行卡 ， 原来 使用 的 银行卡 怎样 消除	__label__企业易付宝
账号 的 身份证号 和 姓名 不是 我 的 能 不能 修改	__label__易付宝实名认证
刚刚 操作 的 转账 成功 了 吗	__label__转账
零钱宝 到 帐 快 吗 ？	__label__零钱宝
我 想 更换 银行卡 ， 原来 使用 的 银行卡 怎样 消除	__label__易付宝绑定解绑银行卡
如何 查询 自己 的 账号 类别	__label__易付宝账户
目前 任性付 可以 在 哪些地方 使用 ？	__label__任性付
为什么 我 任性贷 里面 的 额度 全没 了	__label__任性贷
我 的 身份证 变更 过 ， 怎么 修改	__label__易付宝实名认证
银行卡 怎么 签约	__label__易付宝绑定解绑银行卡
易付宝 还款 信用卡 有 限额 吗	__label__信用卡还款
理财 已 结息 还 没到 账	__label__理财
任性付 还款 有 限额 吗 ？	__label__任性付
取现 利息 怎么 算 的	__label__任性贷
充值 话费 号码 充值 错误 ， 怎么办 ？	__label__话费
你好 ！ 我 的 零钱宝 存 了 几天 了 为什么 还 没有 收益 啊	__label__零钱宝
任性付 如何 还款 ？	__label__任性付
任性贷 还款 自动 代扣 逻辑 是 什么	__label__任性贷
任性贷 审核 什么 时候 能 完事	__label__任性贷
零钱宝 转入 方式	__label__零钱宝
支付 成功 ， 订单 关闭 是 什么 情况	__label__流量
注销 帐号 时 显示 没有 解除 易购	__label__易付宝注销
预付定金 ， 不能 使用 支付宝 或 微信 吗 ？	__label__支付
为什么 刚刚 银行卡 支付 ，   没输 密码 就 自动 支付 了	__label__易付宝支付密码
零钱宝 能 用来 转帐 吧	__label__零钱宝
付款 码 支付宝 不能 用 吗	__label__支付
登陆密码 如何 找回	__label__易付宝账户
限额 是 多少	__label__转账
为什么 变现 不 成功	__label__理财
任性付 绑定 手机号码 要 变更 怎么办 ？	__label__任性付
易购 和 易付宝 换 绑 流程	__label__易付宝账户
申请 任性贷 提示 公安网 无 基准 照片	__label__任性贷
任性付 的 短信 还款 提示 如何 发送 ？	__label__任性付
在 哪里 还款 “ 随借 随 还 ？	__label__任性付
企业 零钱宝 收益	__label__企业易付宝
忘记 支付 密码	__label__企业易付宝
转账 几天 了 还 不到 帐	__label__转账
为什么 我 的 任性贷 无法 提现 了 呀	__label__任性贷
咨询 修改 账户 的 密保	__label__企业易付宝
我 在 苏宁 门店 购物 ， 如何 使用 任性付 付款 ？	__label__任性付
怎么 申请 批量 付款	__label__企业易付宝
怎么 付	__label__支付
任性付 app 支付 密码 忘记 了 怎么办 ？	__label__任性付
任性付 还款 短信 发送 时间 是 ？	__label__任性付
赎回 会 不会 有 三个 工作日 到 不了 账 的 情况 ？	__label__理财
变现 到期 应付 利息 如何 计算	__label__理财
我 想 用 支付宝 付款	__label__支付
更换 账户 绑定 手机	__label__企业易付宝
我 在 苏宁 门店 使用 任性贷 支付 提示 有 风险	__label__任性贷
能用 微信 付款 吗	__label__支付
任性贷 逾期 影响 个人信用 记录 吗	__label__任性贷
零钱宝 有钱 ， 怎样 买 理财	__label__理财
支付 密码 怎么 找回	__label__企业易付宝
任性付 申请 没 通过 ， 还 可以 再 接着 申请 吗 ？	__label__任性付
忘记 任性付 app 端 登录 密码 怎么办	__label__任性付
任性付 实名认证 中 可以 绑定 哪些 银行 发行 的 银行卡 ？	__label__任性付
万分 收益 的 怎么 来 的	__label__零钱宝
零钱宝 转入 的 限额 和 要求	__label__零钱宝
话费 失败 怎么办	__label__话费
我 之前 的 手机号码 没有 ， 怎么 更改 呢	__label__易付宝修改绑定手机号码
话费 充错 了 ， 给 我 退款	__label__话费
如何 实名认证	__label__企业易付宝
什么 是 账单 日 ， 账单 日 是 几号 ？	__label__任性付
支持 哪些 银行 实名认证	__label__企业易付宝
我 想 买 碎 屏险 怎么 买	__label__延保
申请 任性付 失败 原因 ？	__label__任性付
易付宝 如何 充值	__label__易付宝账户
如何 删除 被绑 的 银行卡	__label__易付宝绑定解绑银行卡
任性贷 逾期 违约 会 产生 哪些 影响	__label__任性贷
使用 任性付 是否 需 明确 用途 ？	__label__任性付
苏宁金融 企业 账户 有 哪些 功能	__label__企业易付宝
pc 上 没法 注销 是 么	__label__易付宝注销
任性付 上报 的 征信 是否 经过 客户 同意 ？	__label__任性付
任性付 申请 年龄 范围 ？	__label__任性付
能 不能 修改 一下 我 的 订单 支付 方式	__label__支付
任性贷 为什么 交易 风险	__label__任性贷
易付宝 解冻 怎么 上传 资料	__label__易付宝账户解冻
意外 保障 是 什么	__label__延保
账户 安全 险 如何 购买	__label__账户安全险
怎么 取消 实名认证	__label__易付宝实名认证
购买 手机 的 延保 服务 都 可以 保 哪些 问题 的	__label__延保
任性付 有 哪些 分期 还款 方式 ？	__label__任性付
任性 借 有 免息期 吗 ？	__label__任性付
怎样 微信 支付 ？	__label__支付
什么 时候 有 收益 啊	__label__零钱宝
我 的 企业 易付宝 支付 密码 忘 了	__label__企业易付宝
我 是 任性贷 的 借款 用户   放款 中得 多久 能 到 账	__label__任性贷
可以 把 账号 注销 掉 再 重新 注册 吗	__label__易付宝注销
易付宝 和 易购 绑定 流程	__label__易付宝账户
如何 修改 任性付 绑定 的 手机号码 ？	__label__任性付
怎么 把 登陆 密码找回	__label__易付宝账户
还款 信用卡 ， 显示 银行 返回 报错 ， 请 耐心 等待 人工审核	__label__信用卡还款
可以 补办 碎 屏险 吗	__label__延保
任性贷 不同 还款 方式 费用 都 一样 吗	__label__任性贷
怎么 没有 支付宝 选项 ？	__label__支付
支付 方式 没有 支付宝   微信 ？	__label__支付
合并 上报 征信 是 什么 鬼 ？	__label__任性付
我 充值 的 话费 需要 发票 报销	__label__话费
一个 人 可以 办理 几个 任性付 账户 ？	__label__任性付
零钱宝 的 钱 不能 全转 银行卡	__label__零钱宝
买 了 理财 ， 被 冻结 ， 在 零钱宝 有 利息 吗	__label__理财
任性付 的 优点 ？	__label__任性付
你们 有 任性贷 业务 吗	__label__任性贷
购买 你们 苏宁 卡能 开发票 吗	__label__礼品卡
我 想要 借款 ， 怎么 操作	__label__任性贷
零钱宝 转出 的 到 银行卡 或 易付宝 余额 限额	__label__零钱宝
易付宝 充值 限额	__label__易付宝账户
怎么 还 没 提现 成功	__label__易付宝账户
什么 是 合并 上报 征信 ？	__label__任性付
请问 礼品 卡 发票 能 开 什么 名目 ？	__label__礼品卡
代扣 失败 的 原因 可能 有 ？	__label__任性贷
什么 是 零钱宝	__label__零钱宝
我 之前 填错 了 身份证 号码 ， 现在 怎样 更改	__label__易付宝实名认证
购买 理财 时用 了 理财券 ， 那 没 到期 想 变现 可以 么	__label__理财
账户 被 冻结 了	__label__易付宝账户解冻
解绑 易购 账户 在 哪	__label__易付宝账户
如何 提高 自己 的 账号 类别	__label__易付宝账户
我 已经 设置 好 了 定期 转 任务 ， 什么 时候 可以 到 账	__label__转账
如何 解绑 易购 账户	__label__易付宝账户
零钱宝 历史 收益 查看 路径	__label__零钱宝
购物 分期 、 任性 借 每月 等额 和 先费 后本 选择 期数 分别 是 多少 ？	__label__任性付
我 想 修改 实名认证	__label__易付宝实名认证
委托 提现 开通 后 ， 还 能 自己 提现 吗 ？	__label__企业易付宝
批量 付 提示 检测 不到 易玺 ， 怎么办 ？	__label__易玺
任性贷 起购 金额 多少	__label__任性贷
随借 随 还 怎么 操作 啊 ？	__label__任性付
提现 怎么 这么 慢	__label__易付宝账户
苏宁 电子卡 或 实体 卡 是否 可以 根据 我 的 要求 开发票	__label__礼品卡
如何 操作 随借 随 还	__label__任性付
任性付 哪些 业务 并入 账单 ？	__label__任性付
任性付 借款 支持 哪些 银行 发行 的 借记卡 ？	__label__任性付
最少 可以 转入 多少 金额 到 企业 零钱宝	__label__企业易付宝
昨晚 上 变现 失败 ， 今天 可以 継 续	__label__理财
取消 绑定 的 银行卡	__label__易付宝绑定解绑银行卡
如何 注销 易玺	__label__易玺
兑换 的 理财券 在 哪查	__label__理财
转账 支持 可以 在 转账 到 哪 几家 银行	__label__转账
申请 的 任性贷 一直 在 审核 中 几天 了	__label__任性贷
账户 类型 怎么 选择 ， 选择 错误 怎么办	__label__企业易付宝
怎么 我 的 任性贷 审核 那么 久 呢	__label__任性贷
任性付 代扣 还款 的 扣款 顺序 是 什么 ？	__label__任性付
手势 密码 如何 设置	__label__易付宝账户
账户 无法 正常 登录 ， 页面 显示 营业执照  身份证 即将 到期 或 已经 过期	__label__企业易付宝
实名认证 通过率 高 的 银行 有 哪些 ？	__label__任性付
没有 收到 延保 的 发票	__label__延保
零钱宝 直接 进入 的 网址 是 ?	__label__零钱宝
流量 怎么 还 没有 到	__label__流量
如何 更改 名字	__label__易付宝实名认证
贷款 要 提供 什么 材料	__label__任性贷
份额 怎么 确认	__label__理财
延保 如何 购买	__label__延保
我 的 零钱 怎么 转 银行卡 ， 原来 的 卡 不用 了	__label__零钱宝
家电 买 的 不到 一年 还 能 买 延保 吗	__label__延保
能 微信 支付 吗	__label__支付
初级 认证 条件	__label__易付宝实名认证
账号 挂失 是 干嘛 的	__label__易付宝账户
如何 分期付款	__label__支付
这个 盗抢险 有 详细 介绍 吗 ？	__label__延保
固收 跟 变现 通 有 什么 区别	__label__理财
任性付 账单 中 不 分期 贷款 收费 吗 ？	__label__任性付
之前 存 了 定期 ， 现在 要 急用 ， 要 怎么 提现 呢	__label__理财
绑定 手机 可以 更换 吗	__label__易付宝修改绑定手机号码
任性付 贷款 逾期 的 后果 是 什么 ？	__label__任性付
如何 操作 随借 随 还 ？	__label__任性付
支付 密码 怎么 找回	__label__易付宝支付密码
提现 多久 到 账	__label__易付宝账户
企业 易付宝 绑定 的 是 以前 的 手机号 怎么办	__label__企业易付宝
我 的 流量 到 了 吗	__label__流量
不 支持 支付宝 或者 微信 扫码 付款 么	__label__支付
能 添加 其他 的 定期 转 业务 吗	__label__转账
预约 购买 的 理财产品 ， 到 现在 还 没 成功 ， 怎么办 ？	__label__理财
要求 企业 易付宝 账户 实名认证 的 原因	__label__企业易付宝
零钱宝 明细 是否 支持 导出	__label__零钱宝
怎样 取消 变现	__label__理财
为什么 要 做 实名认证 ？	__label__任性付
定期 转 了 以后 有 短信 通知 我 吗	__label__转账
企业 易付宝 有 什么 好处	__label__企业易付宝
如何 购买 易玺	__label__易玺
我 任性贷 额度 在 哪类 店面 能 消费	__label__任性贷
如何 查看 我 的 征信 报告 ？	__label__任性付
延保 发票 没有 收到	__label__延保
苏宁 卡有 什么 作用	__label__礼品卡
变现 的 记录 在 哪边 查询	__label__理财
怎么 挂失 账户	__label__易付宝账户
企业 易付宝 支付 密码 忘 了 怎么弄	__label__企业易付宝
在 任性付 贷款 期间 换货 如何 处理 ？	__label__任性付
任性贷 如何 还款	__label__任性贷
购买 的 固收 理财 ， 怎么 一直 都 是 在 确认 中	__label__理财
任性贷 在 哪儿	__label__任性贷
如何 冻结 任性付 账户 ？	__label__任性付
我 是 31 号 办理 的 分期 ， 那 2 月 是 几号 还款	__label__任性贷
为何 我 提现 还 没到 账	__label__易付宝账户
现金 分期 单笔 申请 最高 额度 是 为 多少	__label__任性贷
支付宝 可以 支付 吗	__label__支付
变现 了 几笔 钱 　 到 现在 没有 到 帐	__label__理财
什么 是 七日 年化 收益率	__label__零钱宝
如何 查询 购物 卡 的 余额 的 呢 。	__label__礼品卡
任性 借到 账 时间 是 ？	__label__任性付
银行卡 怎么 解绑	__label__企业易付宝
企业 零钱宝 产品 有 保底 收益 么 ， 收益 如何 计算	__label__企业易付宝
为什么 人脸识别 失败	__label__任性贷
办理 了 自动 代扣 ， 什么 时间 扣款 ？	__label__任性付
如何 高级 认证	__label__易付宝实名认证
我 账号 申请 解冻 ， 很久 了 ， 一直 在 审核 中	__label__易付宝账户解冻
怎么 查 我 前两天 收益	__label__零钱宝
高级 认证 多长时间 审核	__label__易付宝实名认证
变现 的 资金 是 怎么 计算 的	__label__理财
一天 内 审核 ， 我 都 过 了 一天 了 ， 为什么 还 没有 答复	__label__任性贷
苏宁 卡   购买 后能 开 什么 发票	__label__礼品卡
理财 到期 好 几天 还 未 到 账	__label__理财
请问 苏宁 卡 怎么 购买	__label__礼品卡
怎么 解冻 易付宝	__label__易付宝账户解冻
充值 流量 什么 时候 到 账 ?	__label__流量
流量 充错 了 ， 给 我 退款	__label__流量
不 可以 货到付款 吗	__label__支付
三 证 合一 填写	__label__企业易付宝
任性付 何时 可 提前 结清 ？	__label__任性付
我 这个 号 怎么 给 我 冻结 呢	__label__易付宝账户解冻
企业 易付宝 的 功能 有 哪些	__label__企业易付宝
为什么 会 变现 失败	__label__理财
实名认证 时 银行 账户 预留 的 手机号 需要 与 注册 时 填写 的 手机号 保持一致 吗 ？	__label__任性付
企业 易付宝 怎么 登录	__label__企业易付宝
银行卡 限额 能 修改 吗 ？	__label__支付
企业 易付宝 支付 密码 是 什么	__label__企业易付宝
任性付 申请 后 多长时间 可以 知道 结果 ？	__label__任性付
怎么 进入 零钱宝	__label__零钱宝
如何 解除 苏宁易购 与 苏宁金融 的 绑定	__label__易付宝账户
支付 密码 怎么 找回	__label__易付宝支付密码
任性付 是 循环 类 贷款 吗 ？	__label__任性付
开 预付卡 的 发票 可以 开明 细 吗 ？ 需要 公司 盖章 的	__label__礼品卡
我 都 把 信用卡 删除 了 ， 为什么 短信 提醒 我 还款	__label__信用卡还款
请问 如何 变现 数据 如何 查阅	__label__理财
任性贷 额度 小 怎么 提额	__label__任性贷
易付宝 账号 怎么 能 注销	__label__易付宝注销
任性贷 借款 有 了 额度 怎么 借款 不 通过	__label__任性贷
随借 随 还 如何 收取 费用 ？	__label__任性付
可以 修改 账单 日 吗 ？	__label__任性付
企业 汇款 怎么 操作	__label__企业易付宝
任性付 还款 限额 是 多少	__label__任性付
苏宁金融 怎么 解绑 易购	__label__易付宝账户
什么 是 固收 理财	__label__理财
支付宝 为什么 不能 付	__label__支付
怎么 用 微信 支付	__label__支付
账号 挂失 怎么 操作	__label__易付宝账户
委托 提现 如何 修改 规则	__label__企业易付宝
任性付 贷款 逾期 后果 是 什么 ？	__label__任性付
能 分期 吗	__label__支付
什么 是 委托 提现 ？	__label__企业易付宝
任性付 逾期 会 影响 个人信用 吗 ？	__label__任性付
账号 有没有 买 保险 的	__label__账户安全险
任性付 是否 可以 提前 还款 ？	__label__任性付
苏宁 卡是 什么 卡	__label__礼品卡
实名认证 时 提醒 银行 账户 预留 的 手机号 与 注册 时 填写 的 手机号 不 一致 ？	__label__任性付
任性贷 自动 代扣 失败 是 什么 原因	__label__任性贷
如何 解绑 银行卡	__label__企业易付宝
零钱宝 转 出 银行卡 ， 要收 手续费 吗 ？	__label__零钱宝
身份证 号码 填写 错误 怎么 修改	__label__易付宝实名认证
企业 易付宝 功能	__label__企业易付宝
零钱宝 提 现有 费用 吗	__label__零钱宝
怎么 注销 账号	__label__易付宝注销
如何 选择 账户 类型	__label__企业易付宝
怎么 申请 任性贷	__label__任性贷
易购 怎么 关联 苏宁金融	__label__易付宝账户
微信 怎么 支付	__label__支付
什么 时候 任性付 会 短信 提醒 还款 ？	__label__任性付
取 现在 怎么 不到 账	__label__企业易付宝
余额 可以 转账 吗	__label__转账
任性付 账单 最小 还款额 是 多少 ？	__label__任性付
注销 易玺 咨询	__label__易玺
网银 不 可以 支付 吗	__label__支付
延保 服务 都 可以 保 哪些 问题 的	__label__延保
为什么 要 实名认证	__label__任性付
我用 银行卡 给 信用卡 有 限额 吗 ？	__label__信用卡还款
之前 企业 账户 绑定 的 手机号码 没有 用 了 ， 现在 要 换成 我 新 号码	__label__企业易付宝
为什么 不能 用 支付宝 或者 微信付	__label__支付
账户 冻结 怎么办 ？	__label__任性付
任性贷 借款 可以 分期	__label__任性贷
激活 以后 怎么 不能 正常 操作 使用 易玺	__label__易玺
设置 了 小额 免 密码 付款 不想 设置 了 怎么办	__label__易付宝支付密码
变 现钱 怎么 不见 了	__label__理财
没有 出现 解除 银行卡 的 功能	__label__易付宝绑定解绑银行卡
修改 绑定 手机 如何 操作	__label__易付宝修改绑定手机号码
零钱宝 支持 , 支付宝 转入 吗	__label__零钱宝
流量 有效期 是 多久 ？	__label__流量
实名认证 需要 哪些 填写 哪些 信息	__label__企业易付宝
任性付 的 额度 是否 可以 循环 ？	__label__任性付
批量 付款 ， 一般 多长时间 到 账 ？	__label__企业易付宝
申请变现 如果 不 成功 ， 多长时间 可以 再次 申请	__label__理财
账号 冻结 怎么办	__label__易付宝账户
苏宁 卡 有效期 多久	__label__礼品卡
零钱宝 转 出 ， 周末 也 可以 转 吧	__label__零钱宝
苏宁 卡 过期 了 怎么办	__label__礼品卡
为什么 要 选择 任性付 ？	__label__任性付
企业 易付宝 如何 绑定 银行卡	__label__企业易付宝
申请 任性付 没有 通过 ， 要 多久 才能 再次 重新 申请 ？	__label__任性付
理财 的 区别	__label__理财
任性付 上报 征信 对 我 的 信用 记录 有 什么 影响 吗 ？	__label__任性付
提前 变现 的话 ， 为什么 累积 金额 和 可变 现金额 不 一样 呢	__label__理财
企业 易付宝 银行卡 怎么 签约	__label__企业易付宝
账号 登陆	__label__易付宝账户
提现 没有 到 账 ， 一直 在 处理 中	__label__企业易付宝
任性 借 如何 收费 ?	__label__任性付
任性贷 支持 借款 吗	__label__任性贷
用 微信 支付 可以 吗	__label__支付
贷款 要 实名认证 吗	__label__任性贷
什么 是 每 万分 收益	__label__零钱宝
我 提交 了 任性付 申请 ， 但 并 没有 成功 ， 是 什么 原因 ？	__label__任性付
变现 的 金额 和 利率 如何 设置	__label__理财
昨天 申请 的 任性贷 ， 为啥 今天 还 在 审核 呢	__label__任性贷
我要 注销 帐	__label__易付宝注销
苏宁 卡 购买 的 商品 退款 退回 哪边	__label__礼品卡
如何 更换 绑定 手机号码	__label__易付宝修改绑定手机号码
任性付 为什么 要 上报 征信 ？	__label__任性付
易付宝 支付 密码 如何 修改	__label__易付宝支付密码
如何 修改 激活 信息	__label__易付宝实名认证
扫码支付 时 ， 无 任性贷 支付 选项	__label__任性贷
易付宝 绑定 手机号码 怎么 更改	__label__易付宝修改绑定手机号码
无法 检测 易玺	__label__易玺
定期 转 的 转账 限额 是 多少	__label__转账
实名认证 可以 不 做 吗 ？	__label__任性付
怎么 提升 任性贷 额度	__label__任性贷
定期 理财 怎么 还 没有 收益	__label__理财
怎么 实名认证 打款 还 没有 到 账	__label__企业易付宝
任性贷 逾期 会 影响 个人信用 吗	__label__任性贷
任性付 已出 账单 部分 还款 可以 输入 任意 金额 吗 ？	__label__任性付
变现 一笔 手续费 多少 钱	__label__理财
人脸 认证 为什么 过不去 啊	__label__任性贷
零钱宝 多久 到 帐	__label__零钱宝
任性付 在 哪里 使用 ？	__label__任性付
申请 任性贷 需要 什么 条件	__label__任性贷
怎么 实名认证	__label__任性付
怎么 激活 易玺	__label__易玺
为什么 我 任性贷 借 的 钱 还 不到 账	__label__任性贷
有 什么 贷款 的 产品 么	__label__任性贷
如何 申请 任性付 额度	__label__任性付
任性贷 是 什么	__label__任性贷
变现 高点 利率 怎样 算	__label__理财
需要 更改 实名 注册 信息	__label__易付宝实名认证
购买 了 一款 理财 ， 能否 撤销 呢	__label__理财
零钱宝 提现 可以 不是 原卡 吗	__label__零钱宝
易付宝 充值 限额 多少	__label__易付宝账户
请问 不能 用网 银 支付 吗 ？	__label__支付
不用 易付宝 怎么 买单	__label__支付
如何 主动 还 任性付 账单	__label__任性付
登陆密码 要 修改 怎么办	__label__易付宝账户
提现 没有 到 账 ， 一直 在 处理 中	__label__易付宝账户
高级 认证 审核 多久	__label__易付宝实名认证
通讯录 转账 怎么 用	__label__转账
我 的 支付 密码 忘 了 怎么办	__label__易付宝支付密码
怎么 申请 企业 汇款 操作步骤	__label__企业易付宝
提现 到 其他 银行卡 上要 多长时间 才 会 到	__label__易付宝账户
零钱宝 可以 用 信用卡 转 吗	__label__零钱宝
使用 任性付 不 分期 购物 ， 如 发生 退货 退款 ， 资金 如何 处理 ？	__label__任性付
怎么 用 支付宝 支付	__label__支付
理财 显示 待 确认 能 取消 吗	__label__理财
零钱宝 转出 到 帐 是 多少 时间	__label__零钱宝
支付宝 不能 付 ？	__label__支付
急 需要 账户 冻结 怎么办 ？	__label__任性付
怎么 解绑 已经 绑定 的 银行卡	__label__易付宝绑定解绑银行卡
先 把 延保 内容 发 我	__label__延保
提现 不到 账	__label__易付宝账户
注销 账号 的 限制 条件	__label__易付宝注销
企业 易付宝 手机号 换 了	__label__企业易付宝
任性贷 能 在 哪些 门店 使用	__label__任性贷
企业 易付宝 账号 如何 注册	__label__企业易付宝
支付 密码 错误 已经 锁定 了	__label__企业易付宝
任性付 借款 有 限额 吗 ？	__label__任性付
有没有 手机 屏保 保险 ？	__label__延保
为什么 不 可以 选择 银联 支付	__label__支付
任性贷 规定 几号 还款	__label__任性贷
零钱宝 最多能 转 多少	__label__零钱宝
零钱宝 产品 有 保底 收益 吗 ? 是否 会 亏本	__label__零钱宝
现在 零钱宝 的 基金 可以 同时 买 两个 ， 是 吧	__label__零钱宝
当时 没买碎 屏险 ， 现在 还 可以 买 吗	__label__延保
想买个 续保 ， 电视机 的	__label__延保
修改 实名认证 的 信息	__label__易付宝实名认证
支付宝 怎么 付 呀	__label__支付
企业 易付宝 支付 密码 怎么 修改	__label__企业易付宝
如何 申请 任性贷	__label__任性贷
充值 话费 提示 请求 参数 不 合法   风控 校验 失败	__label__话费
哪家 银行 支持 信用卡 分期	__label__支付
信息 过期 了 ， 怎么 申请 变更 账户 信息	__label__企业易付宝
基金 什么 时候 确认	__label__理财
我 充值 的 流量 ， 怎么 给 我 发票	__label__流量
易付宝 企业 账户 在 提交 批量 付款 时需 满足 什么 条件 ？	__label__企业易付宝
以前 用 的 是 别人 的 银行卡 进行 了 初级 实名 ， 现在 我 可以 用 自己 的 不	__label__易付宝实名认证
易付宝 注册 怎么 操作	__label__易付宝账户
今天 提交 了 提前 变现 申请 ， 资金 什么 时候 到 帐	__label__理财
使用 任性付 不 分期 购物 ， 如 发生 退货 ， 资金 如何 处理 ？	__label__任性付
任性付 的 还款 顺序 是 ？	__label__任性付
零钱宝 能 转 了 到 易付宝 余额 吗	__label__零钱宝
苏宁 礼品 卡 怎么 使用	__label__支付
企业 易付宝 支付 密码 如何 修改	__label__企业易付宝
零钱 包 的 明细 去 哪里 导出来	__label__零钱宝
我 的 任性贷 在 苏宁 门店 怎么 买 不了 东西 呢	__label__任性贷
为什么 只能 用 苏宁支付 ？	__label__支付
任性贷 怎么 提额 啊	__label__任性贷
任性付 逾期 后 会 冻结 吗 ？	__label__任性付
港澳台 身份 如何 认证	__label__易付宝实名认证
怎么 解除 身份证 绑定	__label__易付宝实名认证
任性付 app 端 登录 密码 忘记 了 怎么办 ？	__label__任性付
申请 没有 通过	__label__任性贷
怎么 把 账号 注销	__label__易付宝注销
变现 的 钱 怎么 和 我 理财 的 资金 不 一样	__label__理财
人脸 验证 总是 失败 是 怎么 搞 的	__label__任性贷
账户 安全 险是 保护 我 苏宁 理财 上 买 的 所有 理财 资金 吗	__label__账户安全险
不是 自己 的 银行卡 如何 支付	__label__支付
现在 支持 哪些 信用卡 分期 呢	__label__支付
任性付 免息期 是 多长时间 ？	__label__任性付
可以 用 支付宝 支付 吗	__label__支付
已经 理财 好 几天 了 ， 怎么 收益 始终 是 0 ?	__label__理财
理财 到期 后 资金 到 哪里	__label__理财
支付宝 怎么 用 不了	__label__支付
转账 失败 后 ， 资金 如何 退还	__label__转账
征信 什么 时候 上报 ？	__label__任性贷
不 可以 微信 或者 支付宝 支付 嘛	__label__支付
申请变现 的 钱   不能 到 银行卡 吗	__label__理财
使用 任性付 借钱 后 钱 怎么 给 我 ？	__label__任性付
微信 和 支付宝 都 不能 支付 吗 ？	__label__支付
通讯录 转账	__label__转账
那个 零钱宝 持有 最大 份额 是 多少 钱	__label__零钱宝
提现 一直 都 没到 账	__label__企业易付宝
如何 解绑 易购	__label__易付宝账户
你 这 利率 算得 不 对	__label__零钱宝
任性贷 借款 可以 分期 吗	__label__任性贷
任性付 已出 账单 部分 还款 可以 输入 任意 金额 吗 ？	__label__任性付
任性贷 在 苏宁 电器 都 能 用 吗	__label__任性贷
转账 怎么 操作	__label__转账
什么 是 基金	__label__理财
放款 要 多久 才 可以 到 ， 一直 显示 放款 中	__label__任性贷
为什么 任性贷 又 不能 买 东西 了 ， 交易 存在 风险	__label__任性贷
账户 安全 险 如何 购买	__label__账户安全险
能 微信 红包 付款 么	__label__支付
低 风险 的 理财 有 哪些	__label__理财
怎么 用 信用卡 支付	__label__支付
可 变现 是不是 提取 了 带 利息 的	__label__理财
易付宝 和 易购 怎么 换 绑	__label__易付宝账户
她 注册 的 时候 搞 成富 什么 基金 了 ， 她 想 搞 成 和 我 一样 的 广发	__label__零钱宝
支付宝 不好 付款 吗 ？	__label__支付
提现 总是 申请 失败	__label__企业易付宝
任性贷 申请 什么 时候 有 结果	__label__任性贷
如何 关闭 小额 免密	__label__易付宝支付密码
定期 转是 什么	__label__转账
苏宁 卡 为什么 不能 再 支付 时候 使用	__label__支付
外籍 企业法人 怎么 实名认证	__label__企业易付宝
我 现在 想 更 改为 我 的 身份证	__label__易付宝实名认证
如何 使用 苏宁 卡 支付	__label__支付
任性付 可 用于 什么 ？	__label__任性付
这个 钱 怎么 算 的 和 支付宝 一样 吗	__label__零钱宝
支付 密码 重置 怎么 操作	__label__企业易付宝
零钱宝 的 收益 是 按照 单利 计算 还是 复利 计算 的 ?	__label__零钱宝
我 的 负债  贷款 情况 如何 在 征信 报告 上 体现 ？	__label__任性付
如何 使用 信用卡 分期	__label__支付
申请 任性付 失败 原因 ？	__label__任性付
苏宁 卡 怎么 用 ， 看到 绑定 的 卡 可以 使用 ， 怎么 买 东西 时 不 显示 有 苏宁 卡 ？	__label__支付
账号 还 没 解冻	__label__易付宝账户解冻
高级 实名认证 要 多久	__label__易付宝实名认证
选择 部分 还款 时 可以 还 任意 金额 吗 ？	__label__任性付
申请变现 如果 不 成功 ， 多长时间 可以 再次 申请	__label__理财
请问 我 为什么 老是 刷 脸 失败	__label__任性贷
为什么 我 的 任性贷 没有 成功 啊	__label__任性贷
有 一笔 提现 未到 账	__label__易付宝账户
任性付 账单 还款 日 是 几号 ？	__label__任性付
怎么 用 微信 或者 支付宝 支付 我 的 订单 呢 ？	__label__支付
任性付 逾期 违约金 如何 收取 ？	__label__任性付
是否 支持 差额 还款 ？	__label__任性付
如何 初级 认证	__label__易付宝实名认证
任性付 上报 征信 对 我 的 信用 记录 有 什么 影响 吗 ？	__label__任性付
这个 账号 可以 更改 姓名	__label__易付宝实名认证
提现 的 到 现在 还 没到	__label__企业易付宝
如何 使用 任性贷	__label__任性贷
易付宝 账号 如何 挂失	__label__易付宝账户
我 的 账号 被 冻结 了	__label__易付宝账户解冻
易付宝 的 软件 在 哪里 下	__label__易付宝账户
任性贷 不同 还款 方式 收费标准 有 什么 不 一样	__label__任性贷
任性付 有 哪些 优势 ？	__label__任性付
购买 苏宁 电子卡 ， 怎么 没 发货	__label__礼品卡
理财产品 是否 支持 提前 赎回	__label__理财
实名认证 里面 的 姓名 和 身份证 还 不是 我 怎么办	__label__易付宝实名认证
我 买 的 碎 屏险 没 发票 吗	__label__延保
账号 突然 被 冻结 ， 怎么办	__label__易付宝账户解冻
零钱宝 转 到 易付宝 时时 到 帐 的 吗	__label__零钱宝
我 的 任性贷 额度 为什么 被 收回	__label__任性贷
任性贷 产品 费率 怎么 计算	__label__任性贷
零钱宝 显示 转入 超过 限额	__label__零钱宝
已买 商品 怎么 购买 延保	__label__延保
帐户 安全 险 可以 保 零钱宝 和 理财 吗 ？	__label__账户安全险
企业 零钱宝 如何 转 出	__label__企业易付宝
信用卡 还款 限额 是 多少	__label__信用卡还款
变现 的 费用 是 多少	__label__理财
我 朋友家 人 可以 银联 支付 ， 我 为什么 不 可以	__label__支付
我 的 负债  贷款 情况 如何 在 征信 报告 上 体现 ？	__label__任性付
为什么 我 的 任性贷 审核 ， 审核 了 一天 还 在 审核 中	__label__任性贷
今天 买 零钱宝 啥时候 算账	__label__零钱宝
支付 成功 ， 订单 关闭 是 什么 情况	__label__话费
银行卡 有钱 ， 什么 时候 自动 代扣	__label__任性贷
易付宝 和 易购 怎么 绑定	__label__易付宝账户
为什么 我 前面 都 能 借款 今天 确 不能 借 了 呢	__label__任性贷
零钱宝 收益 计算公式	__label__零钱宝
请问 银行卡 怎么 解绑	__label__企业易付宝
任性付 账单 最低 还款额 如何 计算 ？	__label__任性付
可以 提高 转账 限额 吗	__label__转账
最低 还款额 是 什么	__label__任性付
提现 怎么 这么 慢	__label__企业易付宝
怎么 提现 都 不到 账	__label__易付宝账户
我 想 把 你们 平台 信用卡 还款 提醒 关闭 ， 怎么 关	__label__信用卡还款
零钱宝 转出 至 企业 银行 账户 有 次数 和 额度 限制	__label__企业易付宝
手势 密码 如何 设置	__label__易付宝账户
定金 怎么 没有 支付宝 选项 ？	__label__支付
任性付 还款 限额 是 多少	__label__任性付
为什么 我 扫 码付 没有 显示 能 用 任性贷 付 支付 功能	__label__任性贷
部分 还款 可以 还款 任意 金额 吗 ？	__label__任性付
任性付 手续费 是 多少 ？	__label__任性付
批量 付款 一般 多久 到 账	__label__企业易付宝
账户 安全 险保 零钱宝 吗	__label__账户安全险
有碎 屏险 吗 ？	__label__延保
任性付 手续费 收取 标准 是 什么 ？	__label__任性付
为什么 我 提现 转账 还 没到	__label__企业易付宝
任性贷 可以 提前 还款 吗	__label__任性贷
定期 是 按 约定 的 利息 结算 收益	__label__理财
任性付 分期 最低 金额 是 多少 ？	__label__任性付
如何 解绑 账户 银行卡	__label__企业易付宝
怎样 看 当日   每 万份 收益	__label__零钱宝
没有 支付宝 付款 吗	__label__支付
我 的 任性贷 怎么 显示 额度 为 0 了	__label__任性贷
我 的 任性付 绑定 的 银行卡 可否 更换 ？	__label__任性付
那个 有 三个 基金 一起 的 那个 叫 什么	__label__零钱宝
转入 零钱宝 的 上限 是 多少	__label__零钱宝
易付宝 是 什么	__label__易付宝账户
苏宁 卡 单个 订单 可以 使用 多张 吗 ？	__label__礼品卡
激活	__label__企业易付宝
如何 企业 汇款	__label__企业易付宝
话费 充错 了 ， 号码 是 空号 ， 可以 退款 吗	__label__话费
任性贷 还款 流程 是 什么	__label__任性贷
流量 充错 了 ， 号码 是 空号 ， 可以 退款 吗	__label__流量
密码 不 对 怎么办	__label__易付宝支付密码
原来 手机号 不用 了	__label__易付宝修改绑定手机号码
账户 里 还有 钱 的话 可以 直接 注销 账号 吗	__label__易付宝注销
变现 的 规则	__label__理财
目前 任性付 可以 在 哪些地方 使用 ？	__label__任性付
我 的 话费 充值 订单 失败 了	__label__话费
如果 使用 信用卡 支付	__label__支付
征信 上报 贷款 笔数 多会 对 个人 征信 有 影响 么 ？	__label__任性付
本期 可变 现金额 是 如何 计算 的	__label__理财
零钱宝 明细 导不 出来 吗	__label__零钱宝
高级 认证 一直 显示 审核 中	__label__易付宝实名认证
理财 安全可靠 吗	__label__理财
定期 转 限额	__label__转账
一个 身份证号 可以 绑定 几个 任性付 账户 ？	__label__任性付
任性付 的 购物 贷款 支持 哪些 商品 ？	__label__任性付
定期 理财 申请变现 为什么 每次 都 失败	__label__理财
补买碎 屏险 服务	__label__延保
银行 的 手机号 没有 修改 ， 怎么 支付	__label__支付
为什么 不能 用 微信 或者 支付宝 支付	__label__支付
如何 使用 任性付 ？	__label__任性付
申请变现 的 交易 一旦 成功 是 马上 收到 资金 吗	__label__理财
我 想 解除 绑定 银行卡 ， 怎么 操作	__label__企业易付宝
任性贷 在 哪 开通	__label__任性贷
人脸识别 不过 什么 情况	__label__任性贷
为什么 转账 失败	__label__转账
不 记得 任性付 APP 支付 密码 怎么 处理	__label__任性付
转账 是 实时 到 账 吗	__label__转账
可 变现 是 随时 可 变现 吗	__label__理财
怎么 提现 都 不到 账	__label__企业易付宝
如何 进行 实名认证 ？	__label__任性付
为什么 我 的 零钱 包 没有 收益	__label__零钱宝
我 怎么 拿到 任性付 借 的 钱 ？	__label__任性付
忘记 任性付 APP 支付 密码 怎么办	__label__任性付
别人 卡 可以 转入 自己 的 零钱宝 吗	__label__零钱宝
零钱宝 收益 计算公式	__label__零钱宝
任性贷 还款 日 是 几号	__label__任性贷
申请 任性贷 为什么 没有 通过	__label__任性贷
信用卡 还款 有 限额 吗 ？	__label__信用卡还款
除了 苏宁支付 方式 ， 没有 其他 支付 方式 了 吗 ？	__label__支付
当 账户 余额 不够 时 ， 任性付 是否 会 扣款	__label__任性付
任性贷 为什么 扫码 消费 一直 提示 不 安全 ， 请 更换 其他 支付 方式	__label__任性贷
随借 随 还 手续费 是 多少	__label__任性付
怎么 换 基金 ， 钱 在 零钱宝 上	__label__零钱宝
怎么 才能 解绑 易购 账户	__label__易付宝账户
零钱宝 给 盗 了 怎么办	__label__零钱宝
委托 提现 多久 能 到 账 ？	__label__企业易付宝
我 买 的 电器 保险 ， 为什么 没有 发票	__label__延保
我要 怎么 更改 绑定 的 手机号	__label__易付宝修改绑定手机号码
如何 找回 任性付 app 端 支付 密码 ？	__label__任性付
申请 任性付 后 最快 多久 获得 额度 ？	__label__任性付
可以 用 银行卡 购买 理财 吗 ？	__label__理财
为啥 要 上报 征信 ？	__label__任性付
理财券 的 来源	__label__理财
不能混合 支付 吗 ？	__label__支付
我 多久 能 拿到 任性付 的 钱 ？	__label__任性付
如何 操作 实名认证	__label__任性付
超 限额 怎么办	__label__转账
任性付 最高 能 申请 多少 钱 啊 ？	__label__任性付
充 话费 怎么 这么 慢	__label__话费
企业 易付宝 提现 什么 时候 到 账	__label__企业易付宝
任性贷 是 自己 申请 提额 ， 还是 自动 提额	__label__任性贷
有 哪些 理财	__label__理财
实名认证 流程	__label__企业易付宝
任性付 借款 支持 哪些 银行 发行 的 借记卡 ？	__label__任性付
任性付 如何 主动 还款 ？	__label__任性付
随借 随 还 支持 部分 还款 吗 ？	__label__任性付
买 的 投资 理财 ， 为什么 金额 在 零钱宝 中	__label__理财
企业 易付宝 支付 密码 怎么 找回	__label__企业易付宝
易付宝 给 信用卡 还款 在 哪里	__label__信用卡还款
我 是 31 号 办理 的 分期 ， 没有 30 天 的 月份 是 哪天 还款	__label__任性贷
银行卡 预留 的 号码 不用 了 怎么办	__label__支付
还 了 张 信用卡 ， 卡号 对 了 人名 错 了 ， 能 还 上 么	__label__信用卡还款
找 我 苏宁易购 代付 ， 我 是不是 不 可以 用 苏宁 卡 支付	__label__支付
流量 充值 错误 ， 怎么办 ？	__label__流量
如何 更换 任性付 绑定 银行卡	__label__任性付
如何 申请 任性贷	__label__任性贷
信用卡 信息 填错 了 ， 今天 什么 时候 能 还 回来	__label__信用卡还款
理财 多久 可以 变现	__label__理财
什么 是 七日 年化 收益率	__label__零钱宝
如何 查看 我 的 征信 报告 ？	__label__任性付
我 的 易付宝 冻结 了	__label__易付宝账户解冻
在 哪能 看 我 是 几类 用户	__label__易付宝账户
高级 实名认证 能 加快 审核	__label__易付宝实名认证
支付 密码 输错 5 次 怎么办	__label__易付宝支付密码
我 的 易付宝 怎么 还 没 解冻 啊	__label__易付宝账户解冻
设置 好 的 定期 转 任务 何时 到 账	__label__转账
什么 是 批量 付款 至 易付宝 账户 ， 批量 付款 至 易付宝 账户 的 流程	__label__企业易付宝
易付宝 账户 险快 到 时间 了 ， 如何 再次 购买	__label__账户安全险
任性贷 逾期 会 被 罚 么	__label__任性贷
有没有 旧机碎 屏险	__label__延保
在 哪 可以 还款 信用卡	__label__信用卡还款
已 在 工商局 完成 三 证 合一 的 您 在 实名认证 过程 中 三 证号码 怎么 填写	__label__企业易付宝
企业 汇款 退款 周期	__label__企业易付宝
任性贷 开通 需要 多久	__label__任性贷
任性付 提供 哪些 还款 服务 ？	__label__任性付
可以 微信 支付 吗	__label__支付
变现 失败 怎么办	__label__理财
请问 怎么 修改 支付 密码	__label__企业易付宝
零钱宝 可以 组和 支付 吗	__label__零钱宝
定期 转 失败 了 ， 资金 怎么 退回	__label__转账
苏宁金融 APP 如何 下载	__label__易付宝账户
任性付 逾期 后 额度 无法 使用 怎么办 ？	__label__任性付
为什么 要 合并 上报 征信 ？	__label__任性付
我 怎么 申请 不了 任性贷	__label__任性贷
已经 上报 给 人行 的 多笔 贷款 记录 还 可以 合并 么 ？	__label__任性付
我 充值 的 流量 需要 发票 报销	__label__流量
怎样 重设 支付 密码	__label__易付宝支付密码
查询 苏宁 卡 的 余额	__label__礼品卡
任性付 代扣 还款 的 扣款 顺序 是 什么 ？	__label__任性付
帐户 安全 险 可以 保障 零钱宝 和 定期 理财 吗 ？	__label__账户安全险
账户 修改 手机号码 在 哪 修改	__label__企业易付宝
汇款 退款 周期	__label__企业易付宝
任性贷 不同 还款 方式 计费 规则 都 一样 吗	__label__任性贷
在 任性付 贷款 期间 换货 如何 处理 ？	__label__任性付
登陆密码 忘记 了 怎么办	__label__易付宝账户
支付 成功 为什么 失败 了	__label__话费
老年人 能 申请 任性贷 么	__label__任性贷
苏宁 卡有 什么 作用	__label__礼品卡
怎么 又 给 冻结 了	__label__易付宝账户解冻
易付宝 提现 限额	__label__易付宝账户
申请 任性付 没有 通过 ， 要 多久 才能 再次 重新 申请 ？	__label__任性付
企业 零钱宝 是 什么	__label__企业易付宝
任性付 逾期 利息 是 多少	__label__任性付
人脸识别 失败 咋 回事	__label__任性贷
怎么 激活 企业 易付宝	__label__企业易付宝
我 怎么 没有 找到 信用卡 还款 的 地方	__label__信用卡还款
任性付 自动 代扣 时间 是 ？	__label__任性付
怎么 解冻 我 的 支付 账户	__label__易付宝账户解冻
苏宁 礼品 卡 过期 了 还 能 用 吗 ？	__label__礼品卡
我要 借款 利息 怎么 计算	__label__任性贷
用 微信 支付 可以 吗	__label__支付
账户 安全 险 保障 我 哪些 资金	__label__账户安全险
提示 密码 错误 ，   忘记 了	__label__易付宝支付密码
实名认证 是 什么 意思 ？	__label__任性付
为什么 转账 在 处理 中	__label__转账
怎么 注册 企业 易付宝 账号	__label__企业易付宝
任性付 账单 中 分期 贷款 的 首期 如何 收费 ？	__label__任性付
我 想要 解绑 银行卡	__label__企业易付宝
账号 解挂 怎么 操作	__label__易付宝账户
已 发起 变现 请问 什么 时候 能够 成功	__label__理财
分期付款 一定 要 信用卡 吗	__label__支付
易付宝 绑定 的 是 以前 的 手机号 怎么办	__label__易付宝修改绑定手机号码
零钱宝 收益 是 单利 还是 复利	__label__零钱宝
易付宝 提现 额度 多少	__label__易付宝账户
任性付 账单 中 分期 贷款 的 首期 如何 收费 ？	__label__任性付
理财 是否 随时 可以 赎回	__label__理财
流量 充错 了 ， 怎么办	__label__流量
有 一笔 转帐 对方 说 未 收到	__label__转账
任性付 的 额度 是否 可以 循环 ？	__label__任性付
怎么 选 账户 类型	__label__企业易付宝
如何 修改 企业 易付宝 登录 密码	__label__企业易付宝
任性付 逾期 后 能否 正常 使用 额度 ？	__label__任性付
